County Name,Year,Population,# of FM Physicians,# of IM Physicians,# of P Physicians,Total Physicians,Rate Per 100000
Appling,2020,18106,3,5,1,9,49.70727935
Atkinson,2020,7971,1,0,0,1,12.54547736
Bacon,2020,11228,3,3,2,8,71.25044532
Baker,2020,2942,0,2,0,2,67.98096533
Baldwin,2020,44884,7,23,8,38,84.66268604
Banks,2020,19758,2,0,2,4,20.24496407
Barrow,2020,88052,19,6,5,30,34.07077636
Bartow,2020,110458,34,19,10,63,57.03525322
Ben Hill,2020,16456,6,1,1,8,48.61448712
Berrien,2020,19659,4,0,0,4,20.3469149
Bibb,2020,153671,84,142,47,273,177.6522571
Bleckley,2020,12977,3,2,2,7,53.94158897
Brantley,2020,19357,2,0,0,2,10.33217957
Brooks,2020,15413,1,1,0,2,12.97605917
Bryan,2020,42763,14,6,5,25,58.46175432
Bulloch,2020,84340,24,18,10,52,61.65520512
Burke,2020,22271,6,2,2,10,44.90144134
Butts,2020,26424,6,5,1,12,45.41326067
Calhoun,2020,5861,2,0,0,2,34.12386965
Camden,2020,56696,17,10,5,32,56.44137153
Candler,2020,10755,2,2,0,4,37.19200372
Carroll,2020,123982,27,36,11,74,59.68608346
Catoosa,2020,67980,26,7,7,40,58.84083554
Charlton,2020,14338,3,1,0,4,27.89789371
Chatham,2020,289958,115,144,66,325,112.0851985
Chattahoochee,2020,11521,0,0,0,0,0
Chattooga,2020,24803,6,0,0,6,24.1906221
Cherokee,2020,268491,63,55,30,148,55.12289053
Clarke,2020,130457,33,120,24,177,135.6768897
Clay,2020,2734,0,1,0,1,36.57644477
Clayton,2020,298374,44,53,24,121,40.55313131
Clinch,2020,6648,1,2,0,3,45.12635379
Cobb,2020,768283,224,283,146,653,84.994722
Coffee,2020,43709,14,11,6,31,70.92360841
Colquitt,2020,45890,24,10,4,38,82.8067117
Columbia,2020,161988,46,31,23,100,61.73296787
Cook,2020,17468,6,0,0,6,34.34852301
Coweta,2020,153531,22,43,17,82,53.40940917
Crawford,2020,12544,1,0,0,1,7.971938776
Crisp,2020,21882,4,7,7,18,82.25939128
Dade,2020,15894,1,3,1,5,31.45841198
Dawson,2020,28070,15,1,4,20,71.25044532
Decatur,2020,26066,5,3,2,10,38.36415254
DeKalb,2020,768079,250,517,395,1162,151.2865213
Dodge,2020,20229,2,7,1,10,49.43398092
Dooly,2020,12752,3,0,0,3,23.52572146
Dougherty,2020,85468,52,44,20,116,135.7233116
Douglas,2020,148981,18,40,20,78,52.35566951
Early,2020,9998,4,1,1,6,60.0120024
Echols,2020,4018,0,0,0,0,0
Effingham,2020,68432,7,7,2,16,23.38087444
Elbert,2020,19392,6,2,0,8,41.25412541
Emanuel,2020,22724,6,5,1,12,52.8076043
Evans,2020,10558,1,2,0,3,28.41447244
Fannin,2020,26602,9,8,2,19,71.42320126
Fayette,2020,116901,45,60,31,136,116.3377559
Floyd,2020,99566,66,71,17,154,154.6712733
Forsyth,2020,258770,51,49,25,125,48.30544499
Franklin,2020,23979,5,3,2,10,41.70315693
Fulton,2020,1091550,371,893,386,1650,151.1611928
Gilmer,2020,32437,8,2,2,12,36.9947899
Glascock,2020,2959,0,0,0,0,0
Glynn,2020,85926,32,24,18,74,86.12061541
Gordon,2020,58633,27,15,5,47,80.15963706
Grady,2020,24351,12,4,0,16,65.7057205
Greene,2020,19506,4,4,3,11,56.39290475
Gwinnett,2020,954076,182,236,170,588,61.63031037
Habersham,2020,45238,9,9,2,20,44.21061939
Hall,2020,210247,57,119,32,208,98.93125705
Hancock,2020,8635,0,0,0,0,0
Haralson,2020,30254,10,5,1,16,52.88556885
Harris,2020,36588,3,2,0,5,13.66568274
Hart,2020,26473,8,2,0,10,37.77433612
Heard,2020,12027,1,0,0,1,8.314625426
Henry,2020,244227,58,44,39,141,57.73317446
Houston,2020,162543,43,40,17,100,61.52218182
Irwin,2020,9456,2,1,2,5,52.87648054
Jackson,2020,78281,18,19,11,48,61.31756109
Jasper,2020,14599,3,0,0,3,20.5493527
Jeff Davis,2020,15249,5,3,0,8,52.46245655
Jefferson,2020,15238,1,3,1,5,32.81270508
Jenkins,2020,8498,2,1,0,3,35.3024241
Johnson,2020,9517,2,1,0,3,31.52253862
Jones,2020,28845,4,0,1,5,17.33402669
Lamar,2020,19309,5,0,2,7,36.25252473
Lanier,2020,10559,1,1,0,2,18.94118761
Laurens,2020,47966,32,25,7,64,133.4278447
Lee,2020,30474,3,7,2,12,39.37783028
Liberty,2020,63093,13,10,13,36,57.05862774
Lincoln,2020,7913,3,0,0,3,37.91229622
Long,2020,20495,1,1,0,2,9.758477677
Lowndes,2020,119600,28,57,9,94,78.59531773
Lumpkin,2020,35032,13,2,0,15,42.81799498
Macon,2020,12521,3,2,0,5,39.93291271
Madison,2020,30356,1,1,3,5,16.47120833
Marion,2020,8331,2,0,0,2,24.00672188
McDuffie,2020,20872,7,6,1,14,67.07550786
McIntosh,2020,14490,1,0,0,1,6.901311249
Meriwether,2020,21313,2,4,0,6,28.15183222
Miller,2020,5786,4,0,0,4,69.13238852
Mitchell,2020,21319,8,0,2,10,46.90651531
Monroe,2020,27728,4,4,3,11,39.67109059
Montgomery,2020,9180,0,0,0,0,0
Morgan,2020,20166,7,2,0,9,44.62957453
Murray,2020,40402,7,4,1,12,29.70149993
Muscogee,2020,198969,184,59,50,293,147.2591208
Newton,2020,116390,8,16,9,33,28.35295128
Oconee,2020,41884,18,15,12,45,107.4395951
Oglethorpe,2020,15617,0,0,0,0,0
Paulding,2020,177895,16,21,8,45,25.29582057
Peach,2020,27912,11,3,0,14,50.15763829
Pickens,2020,33745,7,19,1,27,80.01185361
Pierce,2020,19619,4,0,0,4,20.388399
Pike,2020,19592,1,1,0,2,10.20824826
Polk,2020,43147,16,2,0,18,41.71784829
Pulaski,2020,11251,4,5,1,10,88.88098836
Putnam,2020,22717,7,2,1,10,44.01989699
Quitman,2020,2377,0,0,0,0,0
Rabun,2020,17697,9,4,1,14,79.10945358
Randolph,2020,6710,2,0,0,2,29.80625931
Richmond,2020,204220,148,200,115,463,226.7162864
Rockdale,2020,91678,25,43,14,82,89.44348699
Schley,2020,5311,0,0,0,0,0
Screven,2020,13978,2,0,0,2,14.3081986
Seminole,2020,7730,4,1,3,8,103.4928849
Spalding,2020,67895,9,20,7,36,53.0230503
Stephens,2020,25761,9,5,9,23,89.28224836
Stewart,2020,6993,3,1,0,4,57.2000572
Sumter,2020,28980,9,7,5,21,72.46376812
Talbot,2020,6005,0,0,0,0,0
Taliaferro,2020,1387,0,0,0,0,0
Tattnall,2020,24888,4,2,0,6,24.10800386
Taylor,2020,8020,0,0,0,0,0
Telfair,2020,15632,4,0,0,4,25.58853634
Terrell,2020,8419,2,1,0,3,35.63368571
Thomas,2020,44685,28,22,9,59,132.0353586
Tift,2020,40848,16,28,10,54,132.1974148
Toombs,2020,26686,6,19,9,34,127.4076295
Towns,2020,12379,7,3,0,10,80.78196946
Treutlen,2020,7077,0,0,0,0,0
Troup,2020,69610,17,28,11,56,80.44821146
Turner,2020,8139,0,0,0,0,0
Twiggs,2020,8012,0,1,0,1,12.48127808
Union,2020,25723,17,2,2,21,81.63900012
Upson,2020,26590,10,11,4,25,94.02030839
Walker,2020,70397,6,6,1,13,18.46669602
Walton,2020,97375,24,13,8,45,46.21309371
Ware,2020,36028,22,20,4,46,127.6784723
Warren,2020,5268,1,0,0,1,18.98253607
Washington,2020,20302,7,6,3,16,78.80996946
Wayne,2020,30161,7,3,5,15,49.73309904
Webster,2020,2609,0,0,0,0,0
Wheeler,2020,7769,3,0,0,3,38.61500837
White,2020,32418,10,3,0,13,40.10117836
Whitfield,2020,105386,28,38,20,86,81.60476724
Wilcox,2020,8251,2,0,1,3,36.35922918
Wilkes,2020,9603,0,1,0,1,10.41341248
Wilkinson,2020,8776,4,1,0,5,56.97356427
Worth,2020,20137,3,0,2,5,24.82991508
